2.311308383941650391e-01
1.876637935638427734e-01
1.980843544006347656e-01
1.933739185333251953e-01
2.069737911224365234e-01
1.876602172851562500e-01
1.941540241241455078e-01
1.952679157257080078e-01
1.914925575256347656e-01
1.889488697052001953e-01
1.966638565063476562e-01
1.935873031616210938e-01
1.948683261871337891e-01
1.934523582458496094e-01
1.936159133911132812e-01
1.984045505523681641e-01
1.861562728881835938e-01
1.980249881744384766e-01
1.896865367889404297e-01
1.909236907958984375e-01
1.938798427581787109e-01
1.904165744781494141e-01
2.086942195892333984e-01
1.900427341461181641e-01
1.920399665832519531e-01
1.912074089050292969e-01
1.896200180053710938e-01
1.885452270507812500e-01
1.877675056457519531e-01
1.950488090515136719e-01
1.911132335662841797e-01
1.965308189392089844e-01
1.888759136199951172e-01
1.868021488189697266e-01
1.959507465362548828e-01
1.932325363159179688e-01
1.844904422760009766e-01
1.896009445190429688e-01
1.848180294036865234e-01
1.901688575744628906e-01
1.943101882934570312e-01
2.091097831726074219e-01
1.926472187042236328e-01
1.919195652008056641e-01
1.909976005554199219e-01
1.966702938079833984e-01
1.955273151397705078e-01
1.856434345245361328e-01
1.999053955078125000e-01
1.908824443817138672e-01
2.031972408294677734e-01
1.984336376190185547e-01
1.888740062713623047e-01
1.849832534790039062e-01
1.867196559906005859e-01
1.952619552612304688e-01
1.871836185455322266e-01
1.932957172393798828e-01
1.847658157348632812e-01
1.871881484985351562e-01
1.886591911315917969e-01
1.891009807586669922e-01
1.873168945312500000e-01
1.847252845764160156e-01
1.902370452880859375e-01
1.885945796966552734e-01
2.117838859558105469e-01
1.917974948883056641e-01
2.099449634552001953e-01
1.915335655212402344e-01
1.890954971313476562e-01
1.901319026947021484e-01
1.877930164337158203e-01
1.918210983276367188e-01
1.889441013336181641e-01
1.853492259979248047e-01
1.960675716400146484e-01
1.855585575103759766e-01
1.858334541320800781e-01
1.898012161254882812e-01
1.900837421417236328e-01
1.895022392272949219e-01
1.907589435577392578e-01
1.877710819244384766e-01
1.891062259674072266e-01
1.896829605102539062e-01
2.006993293762207031e-01
1.885886192321777344e-01
1.869809627532958984e-01
1.919133663177490234e-01
1.826503276824951172e-01
1.904926300048828125e-01
1.978609561920166016e-01
2.058460712432861328e-01
1.892905235290527344e-01
1.920690536499023438e-01
1.931786537170410156e-01
1.875455379486083984e-01
1.913866996765136719e-01
1.975824832916259766e-01
