1.962368488311767578e-01
1.986224651336669922e-01
1.896204948425292969e-01
1.829190254211425781e-01
1.847121715545654297e-01
1.787326335906982422e-01
2.096428871154785156e-01
1.829636096954345703e-01
1.858918666839599609e-01
1.849651336669921875e-01
1.894047260284423828e-01
1.797819137573242188e-01
1.777439117431640625e-01
1.770203113555908203e-01
2.100410461425781250e-01
1.807715892791748047e-01
1.812884807586669922e-01
1.753532886505126953e-01
1.763095855712890625e-01
1.774315834045410156e-01
1.963069438934326172e-01
1.877593994140625000e-01
1.860198974609375000e-01
1.798510551452636719e-01
1.826293468475341797e-01
1.793375015258789062e-01
1.870725154876708984e-01
1.807334423065185547e-01
2.076160907745361328e-01
1.794738769531250000e-01
1.835923194885253906e-01
1.780238151550292969e-01
1.771566867828369141e-01
1.826550960540771484e-01
1.886084079742431641e-01
1.742360591888427734e-01
1.798131465911865234e-01
1.808989048004150391e-01
2.059044837951660156e-01
1.772964000701904297e-01
1.811091899871826172e-01
1.804666519165039062e-01
2.016644477844238281e-01
1.772224903106689453e-01
2.092382907867431641e-01
1.859221458435058594e-01
1.789472103118896484e-01
1.779294013977050781e-01
1.799948215484619141e-01
1.792676448822021484e-01
1.813411712646484375e-01
1.826741695404052734e-01
1.824975013732910156e-01
1.947286128997802734e-01
1.833415031433105469e-01
1.930594444274902344e-01
1.921119689941406250e-01
1.863741874694824219e-01
1.874504089355468750e-01
1.762666702270507812e-01
1.797609329223632812e-01
1.778955459594726562e-01
1.777503490447998047e-01
1.777207851409912109e-01
1.837608814239501953e-01
2.036290168762207031e-01
1.780862808227539062e-01
1.945426464080810547e-01
1.798529624938964844e-01
1.838078498840332031e-01
1.875588893890380859e-01
1.822869777679443359e-01
1.813762187957763672e-01
1.842670440673828125e-01
1.847448348999023438e-01
1.989216804504394531e-01
1.800241470336914062e-01
1.950592994689941406e-01
1.867010593414306641e-01
1.846487522125244141e-01
1.761136054992675781e-01
1.770749092102050781e-01
1.854598522186279297e-01
2.051835060119628906e-01
1.816074848175048828e-01
1.769711971282958984e-01
1.808655261993408203e-01
2.147307395935058594e-01
1.809086799621582031e-01
1.762845516204833984e-01
1.799576282501220703e-01
1.794734001159667969e-01
1.807615756988525391e-01
1.815841197967529297e-01
1.814689636230468750e-01
1.749215126037597656e-01
1.843905448913574219e-01
1.822712421417236328e-01
2.006328105926513672e-01
1.806318759918212891e-01
