1.847665309906005859e-01
8.241319656372070312e-02
2.082056999206542969e-01
2.070269584655761719e-01
1.807012557983398438e-01
1.850080490112304688e-01
1.959650516510009766e-01
7.560753822326660156e-02
2.061431407928466797e-01
1.008107662200927734e-01
1.850931644439697266e-01
1.943731307983398438e-01
2.032473087310791016e-01
1.871666908264160156e-01
2.119886875152587891e-01
2.015039920806884766e-01
1.381378173828125000e-01
1.784906387329101562e-01
9.239578247070312500e-02
1.864266395568847656e-01
2.059910297393798828e-01
2.044632434844970703e-01
1.784634590148925781e-01
1.812570095062255859e-01
1.836090087890625000e-01
1.975493431091308594e-01
1.929728984832763672e-01
1.857256889343261719e-01
1.807932853698730469e-01
1.819195747375488281e-01
1.993470191955566406e-01
9.277224540710449219e-02
1.851952075958251953e-01
1.831176280975341797e-01
1.827254295349121094e-01
1.764280796051025391e-01
2.105703353881835938e-01
2.264320850372314453e-01
8.137011528015136719e-02
2.300486564636230469e-01
2.095282077789306641e-01
2.015709877014160156e-01
1.844031810760498047e-01
1.961829662322998047e-01
1.728689670562744141e-01
1.835901737213134766e-01
1.984980106353759766e-01
1.790349483489990234e-01
1.831965446472167969e-01
1.813781261444091797e-01
1.811945438385009766e-01
2.118391990661621094e-01
1.932344436645507812e-01
1.800103187561035156e-01
1.782028675079345703e-01
2.115957736968994141e-01
1.069121360778808594e-01
1.795563697814941406e-01
1.810429096221923828e-01
1.951899528503417969e-01
2.060482501983642578e-01
2.020323276519775391e-01
1.998486518859863281e-01
1.831088066101074219e-01
1.829795837402343750e-01
7.721662521362304688e-02
1.826281547546386719e-01
1.940801143646240234e-01
1.748981475830078125e-01
1.968593597412109375e-01
1.860377788543701172e-01
1.788964271545410156e-01
1.920979022979736328e-01
1.816947460174560547e-01
1.953775882720947266e-01
2.059566974639892578e-01
2.125153541564941406e-01
8.193898200988769531e-02
1.796736717224121094e-01
1.104311943054199219e-01
1.773147583007812500e-01
1.777143478393554688e-01
2.064330577850341797e-01
7.369232177734375000e-02
1.995606422424316406e-01
1.809666156768798828e-01
1.796579360961914062e-01
1.963057518005371094e-01
1.839704513549804688e-01
1.727335453033447266e-01
8.619570732116699219e-02
1.959271430969238281e-01
1.940574645996093750e-01
1.975734233856201172e-01
2.115731239318847656e-01
1.782639026641845703e-01
1.340372562408447266e-01
2.067077159881591797e-01
8.360552787780761719e-02
2.069609165191650391e-01
