2.083518505096435547e-01
2.236022949218750000e-01
1.908595561981201172e-01
2.448570728302001953e-01
1.975371837615966797e-01
1.982197761535644531e-01
2.002747058868408203e-01
2.173161506652832031e-01
1.940073966979980469e-01
2.177481651306152344e-01
1.947090625762939453e-01
1.955890655517578125e-01
1.973357200622558594e-01
1.939015388488769531e-01
2.234804630279541016e-01
1.951599121093750000e-01
2.333548069000244141e-01
1.871554851531982422e-01
2.166020870208740234e-01
1.998975276947021484e-01
2.573702335357666016e-01
1.869363784790039062e-01
1.985878944396972656e-01
1.911327838897705078e-01
1.890091896057128906e-01
1.953661441802978516e-01
1.960120201110839844e-01
1.920509338378906250e-01
1.895954608917236328e-01
1.876204013824462891e-01
1.905195713043212891e-01
2.293612957000732422e-01
2.194621562957763672e-01
1.879625320434570312e-01
1.913514137268066406e-01
1.879246234893798828e-01
2.008192539215087891e-01
1.916546821594238281e-01
2.151603698730468750e-01
1.915769577026367188e-01
2.188534736633300781e-01
1.920530796051025391e-01
1.883432865142822266e-01
1.921331882476806641e-01
1.897795200347900391e-01
1.871199607849121094e-01
1.900289058685302734e-01
1.980063915252685547e-01
1.887607574462890625e-01
1.937820911407470703e-01
1.970145702362060547e-01
1.908586025238037109e-01
1.900017261505126953e-01
1.882295608520507812e-01
1.904287338256835938e-01
2.153980731964111328e-01
2.190093994140625000e-01
1.905677318572998047e-01
1.945841312408447266e-01
1.906883716583251953e-01
1.939318180084228516e-01
1.908636093139648438e-01
2.337412834167480469e-01
1.901679039001464844e-01
1.909797191619873047e-01
2.704410552978515625e-01
1.923248767852783203e-01
2.175984382629394531e-01
1.888334751129150391e-01
1.905415058135986328e-01
1.923191547393798828e-01
1.893680095672607422e-01
1.900165081024169922e-01
1.905117034912109375e-01
2.003238201141357422e-01
2.226364612579345703e-01
2.185223102569580078e-01
2.132744789123535156e-01
1.940212249755859375e-01
2.144114971160888672e-01
1.908779144287109375e-01
1.914978027343750000e-01
1.945681571960449219e-01
2.206387519836425781e-01
1.950316429138183594e-01
1.868486404418945312e-01
1.908855438232421875e-01
1.871757507324218750e-01
1.898732185363769531e-01
1.917805671691894531e-01
2.204790115356445312e-01
1.898334026336669922e-01
1.864342689514160156e-01
1.884241104125976562e-01
2.158260345458984375e-01
1.880345344543457031e-01
2.152814865112304688e-01
1.914281845092773438e-01
2.014515399932861328e-01
2.176892757415771484e-01
