2.192153930664062500e-01
5.589318275451660156e-02
1.794450283050537109e-01
1.777181625366210938e-01
1.755216121673583984e-01
1.751012802124023438e-01
1.811871528625488281e-01
4.494500160217285156e-02
1.732790470123291016e-01
6.071066856384277344e-02
1.748893260955810547e-01
1.736564636230468750e-01
1.727473735809326172e-01
1.707537174224853516e-01
1.788756847381591797e-01
1.769793033599853516e-01
1.184527873992919922e-01
1.667048931121826172e-01
9.599471092224121094e-02
1.732904911041259766e-01
1.735494136810302734e-01
1.728820800781250000e-01
1.768803596496582031e-01
1.724264621734619141e-01
1.747035980224609375e-01
1.681387424468994141e-01
1.822125911712646484e-01
1.739799976348876953e-01
1.678838729858398438e-01
1.718330383300781250e-01
2.012431621551513672e-01
8.420538902282714844e-02
8.389234542846679688e-02
1.767203807830810547e-01
1.731405258178710938e-01
1.632866859436035156e-01
1.717524528503417969e-01
1.729660034179687500e-01
6.244063377380371094e-02
1.635892391204833984e-01
1.173048019409179688e-01
1.841697692871093750e-01
1.733896732330322266e-01
1.716094017028808594e-01
1.670272350311279297e-01
1.746854782104492188e-01
1.903512477874755859e-01
1.675875186920166016e-01
1.682529449462890625e-01
1.753973960876464844e-01
1.751687526702880859e-01
1.729187965393066406e-01
1.733305454254150391e-01
1.719789505004882812e-01
1.774220466613769531e-01
1.575639247894287109e-01
1.008732318878173828e-01
1.778550148010253906e-01
1.770040988922119141e-01
1.712172031402587891e-01
1.747267246246337891e-01
1.732733249664306641e-01
1.739308834075927734e-01
1.709520816802978516e-01
1.793889999389648438e-01
3.133797645568847656e-02
1.693558692932128906e-01
1.792492866516113281e-01
1.685488224029541016e-01
1.804435253143310547e-01
1.730992794036865234e-01
1.723320484161376953e-01
1.665651798248291016e-01
1.699893474578857422e-01
1.742630004882812500e-01
1.769208908081054688e-01
1.346282958984375000e-01
4.144454002380371094e-02
1.692652702331542969e-01
1.529996395111083984e-01
1.669301986694335938e-01
1.704154014587402344e-01
1.773965358734130859e-01
3.214240074157714844e-02
1.711378097534179688e-01
1.730704307556152344e-01
1.714351177215576172e-01
1.717665195465087891e-01
1.784646511077880859e-01
1.743555068969726562e-01
1.127130985260009766e-01
1.729745864868164062e-01
1.791296005249023438e-01
1.729760169982910156e-01
1.609182357788085938e-01
1.649570465087890625e-01
1.621036529541015625e-01
1.734714508056640625e-01
4.286742210388183594e-02
1.820344924926757812e-01
