2.283098697662353516e-01
2.268841266632080078e-01
2.241461277008056641e-01
2.283186912536621094e-01
2.016756534576416016e-01
2.033851146697998047e-01
2.013156414031982422e-01
2.324907779693603516e-01
1.938672065734863281e-01
2.211766242980957031e-01
1.929585933685302734e-01
2.057201862335205078e-01
2.045912742614746094e-01
1.907169818878173828e-01
2.320737838745117188e-01
1.973040103912353516e-01
2.354674339294433594e-01
1.995940208435058594e-01
2.236418724060058594e-01
2.028384208679199219e-01
2.338626384735107422e-01
1.948134899139404297e-01
2.054462432861328125e-01
1.897506713867187500e-01
1.917238235473632812e-01
1.893548965454101562e-01
1.941652297973632812e-01
1.976606845855712891e-01
1.985116004943847656e-01
1.974995136260986328e-01
1.938989162445068359e-01
2.177655696868896484e-01
2.174642086029052734e-01
1.914632320404052734e-01
1.908724308013916016e-01
1.955118179321289062e-01
1.913840770721435547e-01
1.936495304107666016e-01
2.209782600402832031e-01
2.049174308776855469e-01
2.223391532897949219e-01
1.911013126373291016e-01
1.981084346771240234e-01
1.984593868255615234e-01
1.933712959289550781e-01
1.913645267486572266e-01
2.041263580322265625e-01
1.922676563262939453e-01
1.896457672119140625e-01
1.979992389678955078e-01
2.100882530212402344e-01
1.990871429443359375e-01
1.974997520446777344e-01
1.973376274108886719e-01
1.934220790863037109e-01
2.204639911651611328e-01
2.333440780639648438e-01
1.920526027679443359e-01
1.902542114257812500e-01
1.919834613800048828e-01
1.980848312377929688e-01
1.936757564544677734e-01
2.191188335418701172e-01
1.916813850402832031e-01
1.963961124420166016e-01
2.462258338928222656e-01
1.980316638946533203e-01
2.232966423034667969e-01
1.961376667022705078e-01
1.900959014892578125e-01
1.957404613494873047e-01
1.975498199462890625e-01
1.935024261474609375e-01
1.918635368347167969e-01
1.949367523193359375e-01
2.207026481628417969e-01
2.216060161590576172e-01
2.139186859130859375e-01
1.945171356201171875e-01
2.191786766052246094e-01
1.962130069732666016e-01
1.957786083221435547e-01
1.978237628936767578e-01
2.429599761962890625e-01
1.963584423065185547e-01
2.053463459014892578e-01
1.921646595001220703e-01
1.914601325988769531e-01
1.922895908355712891e-01
1.899840831756591797e-01
2.222535610198974609e-01
2.043480873107910156e-01
1.981194019317626953e-01
1.967902183532714844e-01
2.176449298858642578e-01
1.956329345703125000e-01
2.208728790283203125e-01
1.924333572387695312e-01
2.181463241577148438e-01
2.193531990051269531e-01
