2.140135765075683594e-01
1.878955364227294922e-01
1.883690357208251953e-01
1.872811317443847656e-01
1.839244365692138672e-01
2.010717391967773438e-01
2.021348476409912109e-01
1.868467330932617188e-01
1.866602897644042969e-01
1.971950531005859375e-01
1.851110458374023438e-01
1.835117340087890625e-01
1.861939430236816406e-01
1.842398643493652344e-01
1.865177154541015625e-01
1.898031234741210938e-01
1.850969791412353516e-01
1.835644245147705078e-01
1.835467815399169922e-01
1.862766742706298828e-01
1.863725185394287109e-01
1.855883598327636719e-01
1.858737468719482422e-01
1.821253299713134766e-01
1.851100921630859375e-01
1.861860752105712891e-01
1.832857131958007812e-01
1.842172145843505859e-01
1.828010082244873047e-01
1.852295398712158203e-01
1.844854354858398438e-01
1.837852001190185547e-01
1.851007938385009766e-01
1.851627826690673828e-01
1.845381259918212891e-01
1.837031841278076172e-01
1.850776672363281250e-01
1.857979297637939453e-01
1.851863861083984375e-01
1.866562366485595703e-01
1.864929199218750000e-01
1.857576370239257812e-01
1.850523948669433594e-01
1.855957508087158203e-01
1.870319843292236328e-01
1.851468086242675781e-01
1.853735446929931641e-01
1.842641830444335938e-01
1.927795410156250000e-01
1.848258972167968750e-01
1.828329563140869141e-01
1.905515193939208984e-01
1.856293678283691406e-01
1.852617263793945312e-01
1.842226982116699219e-01
1.998548507690429688e-01
1.857974529266357422e-01
2.012283802032470703e-01
1.846814155578613281e-01
1.849875450134277344e-01
1.860299110412597656e-01
1.854767799377441406e-01
1.826634407043457031e-01
1.854243278503417969e-01
1.851074695587158203e-01
1.836369037628173828e-01
1.849293708801269531e-01
1.844196319580078125e-01
1.845588684082031250e-01
1.854832172393798828e-01
1.837384700775146484e-01
2.000522613525390625e-01
1.848809719085693359e-01
1.857833862304687500e-01
1.886732578277587891e-01
1.842365264892578125e-01
1.869959831237792969e-01
1.858429908752441406e-01
1.872494220733642578e-01
1.852333545684814453e-01
1.851541996002197266e-01
2.006783485412597656e-01
1.866643428802490234e-01
1.884670257568359375e-01
2.183063030242919922e-01
1.944091320037841797e-01
1.840112209320068359e-01
1.865348815917968750e-01
1.862161159515380859e-01
1.848738193511962891e-01
1.860806941986083984e-01
1.851489543914794922e-01
1.862971782684326172e-01
1.840906143188476562e-01
1.907579898834228516e-01
1.845123767852783203e-01
1.857242584228515625e-01
1.844842433929443359e-01
1.829431056976318359e-01
1.987061500549316406e-01
