1.856081485748291016e-01
7.920193672180175781e-02
2.035114765167236328e-01
1.012635231018066406e-01
1.840190887451171875e-01
1.920168399810791016e-01
2.038795948028564453e-01
7.342576980590820312e-02
2.069449424743652344e-01
7.159709930419921875e-02
1.834747791290283203e-01
1.965353488922119141e-01
1.843080520629882812e-01
1.967513561248779297e-01
2.088954448699951172e-01
2.046546936035156250e-01
8.142185211181640625e-02
1.773698329925537109e-01
8.310508728027343750e-02
1.834375858306884766e-01
1.742601394653320312e-01
2.069523334503173828e-01
1.784863471984863281e-01
1.821453571319580078e-01
2.028226852416992188e-01
2.021992206573486328e-01
1.808028221130371094e-01
1.968388557434082031e-01
1.820600032806396484e-01
1.986398696899414062e-01
1.632373332977294922e-01
1.281452178955078125e-01
9.855055809020996094e-02
1.958186626434326172e-01
1.769297122955322266e-01
1.755387783050537109e-01
2.013092041015625000e-01
2.009913921356201172e-01
9.481739997863769531e-02
1.915066242218017578e-01
1.734666824340820312e-01
1.995108127593994141e-01
2.001116275787353516e-01
1.947951316833496094e-01
1.738793849945068359e-01
1.769618988037109375e-01
1.911349296569824219e-01
1.978828907012939453e-01
1.758193969726562500e-01
1.955466270446777344e-01
1.783063411712646484e-01
1.973509788513183594e-01
1.972303390502929688e-01
1.883263587951660156e-01
1.798882484436035156e-01
1.288845539093017578e-01
9.529352188110351562e-02
1.980531215667724609e-01
1.804213523864746094e-01
2.009930610656738281e-01
1.982607841491699219e-01
2.061848640441894531e-01
1.765642166137695312e-01
2.052109241485595703e-01
1.944658756256103516e-01
5.285358428955078125e-02
1.941587924957275391e-01
2.040610313415527344e-01
1.774835586547851562e-01
1.779100894927978516e-01
1.766066551208496094e-01
1.857573986053466797e-01
1.786077022552490234e-01
1.930601596832275391e-01
1.919605731964111328e-01
2.145276069641113281e-01
1.088845729827880859e-01
5.298256874084472656e-02
1.784930229187011719e-01
2.043962478637695312e-01
1.835494041442871094e-01
1.790144443511962891e-01
2.032513618469238281e-01
5.166101455688476562e-02
2.007117271423339844e-01
1.936442852020263672e-01
1.816587448120117188e-01
1.965279579162597656e-01
1.989867687225341797e-01
1.781768798828125000e-01
9.596323966979980469e-02
2.071998119354248047e-01
1.978824138641357422e-01
2.026565074920654297e-01
9.409546852111816406e-02
1.752755641937255859e-01
2.106258869171142578e-01
2.127110958099365234e-01
8.067131042480468750e-02
9.465169906616210938e-02
