1.825649738311767578e-01
1.827180385589599609e-01
1.789648532867431641e-01
1.795437335968017578e-01
1.800448894500732422e-01
1.795766353607177734e-01
1.808736324310302734e-01
1.812834739685058594e-01
1.807920932769775391e-01
1.798636913299560547e-01
1.793365478515625000e-01
1.791779994964599609e-01
1.832196712493896484e-01
1.794562339782714844e-01
1.779775619506835938e-01
1.786780357360839844e-01
1.801390647888183594e-01
1.787109375000000000e-01
1.800906658172607422e-01
1.793429851531982422e-01
1.791336536407470703e-01
1.784145832061767578e-01
1.802527904510498047e-01
1.773574352264404297e-01
1.800644397735595703e-01
1.798322200775146484e-01
1.795597076416015625e-01
1.786668300628662109e-01
1.798541545867919922e-01
1.799263954162597656e-01
1.803522109985351562e-01
1.841635704040527344e-01
1.791224479675292969e-01
1.805427074432373047e-01
1.791183948516845703e-01
1.789922714233398438e-01
1.795916557312011719e-01
1.805839538574218750e-01
1.794641017913818359e-01
1.788547039031982422e-01
1.805820465087890625e-01
1.785469055175781250e-01
1.790270805358886719e-01
1.790454387664794922e-01
1.791834831237792969e-01
1.770548820495605469e-01
1.843359470367431641e-01
1.782491207122802734e-01
1.790997982025146484e-01
1.871745586395263672e-01
1.877820491790771484e-01
1.855721473693847656e-01
1.786723136901855469e-01
1.781260967254638672e-01
1.851758956909179688e-01
1.771576404571533203e-01
1.794335842132568359e-01
1.791739463806152344e-01
1.811225414276123047e-01
1.793088912963867188e-01
1.779422760009765625e-01
1.787030696868896484e-01
1.788628101348876953e-01
1.801993846893310547e-01
1.791651248931884766e-01
1.794674396514892578e-01
1.748414039611816406e-01
1.785032749176025391e-01
1.774432659149169922e-01
1.784875392913818359e-01
1.776511669158935547e-01
1.785948276519775391e-01
1.826930046081542969e-01
1.782345771789550781e-01
1.801996231079101562e-01
1.791515350341796875e-01
1.777133941650390625e-01
1.788096427917480469e-01
1.774201393127441406e-01
1.789901256561279297e-01
1.781036853790283203e-01
1.818327903747558594e-01
1.792039871215820312e-01
2.034485340118408203e-01
1.792893409729003906e-01
1.786165237426757812e-01
1.785573959350585938e-01
1.777942180633544922e-01
1.775867938995361328e-01
1.766142845153808594e-01
1.781706809997558594e-01
1.799590587615966797e-01
1.781866550445556641e-01
1.796860694885253906e-01
1.774911880493164062e-01
1.783955097198486328e-01
1.794486045837402344e-01
1.782512664794921875e-01
1.791460514068603516e-01
1.787128448486328125e-01
