1.816084384918212891e-01
8.571720123291015625e-02
1.772212982177734375e-01
2.102191448211669922e-01
1.761546134948730469e-01
1.795895099639892578e-01
1.812205314636230469e-01
4.443907737731933594e-02
1.721727848052978516e-01
6.038141250610351562e-02
1.821851730346679688e-01
1.700201034545898438e-01
1.731169223785400391e-01
1.708776950836181641e-01
1.721081733703613281e-01
1.729469299316406250e-01
1.230957508087158203e-01
2.004401683807373047e-01
9.594535827636718750e-02
1.738505363464355469e-01
1.742162704467773438e-01
1.932582855224609375e-01
1.681809425354003906e-01
1.774315834045410156e-01
1.730070114135742188e-01
1.691761016845703125e-01
1.753828525543212891e-01
1.757004261016845703e-01
1.750125885009765625e-01
1.692922115325927734e-01
1.712119579315185547e-01
8.417987823486328125e-02
7.757568359375000000e-02
1.700994968414306641e-01
1.704552173614501953e-01
1.635181903839111328e-01
1.716055870056152344e-01
1.727950572967529297e-01
6.609296798706054688e-02
1.630644798278808594e-01
1.164290904998779297e-01
2.098019123077392578e-01
1.767618656158447266e-01
1.713051795959472656e-01
1.661391258239746094e-01
1.725788116455078125e-01
1.743085384368896484e-01
1.700556278228759766e-01
1.722490787506103516e-01
1.706464290618896484e-01
1.717960834503173828e-01
1.734635829925537109e-01
1.821000576019287109e-01
1.669144630432128906e-01
1.724374294281005859e-01
1.565887928009033203e-01
8.737063407897949219e-02
1.741502285003662109e-01
1.699874401092529297e-01
1.744627952575683594e-01
2.013714313507080078e-01
1.781706809997558594e-01
1.764519214630126953e-01
1.706271171569824219e-01
1.675205230712890625e-01
5.809140205383300781e-02
1.689159870147705078e-01
1.730189323425292969e-01
1.689417362213134766e-01
1.810579299926757812e-01
1.721897125244140625e-01
1.715152263641357422e-01
1.661849021911621094e-01
1.712250709533691406e-01
1.709110736846923828e-01
1.770775318145751953e-01
1.417796611785888672e-01
5.903959274291992188e-02
1.692674160003662109e-01
1.541733741760253906e-01
1.716451644897460938e-01
1.699674129486083984e-01
1.770312786102294922e-01
3.129124641418457031e-02
1.653413772583007812e-01
1.742351055145263672e-01
1.709504127502441406e-01
2.063415050506591797e-01
1.789689064025878906e-01
1.651616096496582031e-01
1.189184188842773438e-01
1.773285865783691406e-01
1.733829975128173828e-01
1.802062988281250000e-01
1.492516994476318359e-01
1.695039272308349609e-01
9.438061714172363281e-02
1.729314327239990234e-01
5.935692787170410156e-02
1.727359294891357422e-01
