1.753239631652832031e-01
6.154465675354003906e-02
1.763987541198730469e-01
6.493902206420898438e-02
1.706340312957763672e-01
1.786954402923583984e-01
1.708531379699707031e-01
5.000519752502441406e-02
1.731822490692138672e-01
4.686856269836425781e-02
1.812486648559570312e-01
1.757628917694091797e-01
1.780643463134765625e-01
1.736059188842773438e-01
1.248104572296142578e-01
1.738977432250976562e-01
7.696795463562011719e-02
1.714408397674560547e-01
6.514382362365722656e-02
1.727674007415771484e-01
1.875522136688232422e-01
1.362886428833007812e-01
1.744267940521240234e-01
1.736433506011962891e-01
1.740458011627197266e-01
1.726505756378173828e-01
1.717934608459472656e-01
1.759355068206787109e-01
1.663069725036621094e-01
1.735870838165283203e-01
1.549990177154541016e-01
7.656192779541015625e-02
7.320117950439453125e-02
1.704728603363037109e-01
1.694986820220947266e-01
1.712181568145751953e-01
1.726269721984863281e-01
1.696038246154785156e-01
8.984279632568359375e-02
1.720356941223144531e-01
1.746578216552734375e-01
1.728255748748779297e-01
1.719081401824951172e-01
1.734049320220947266e-01
1.691689491271972656e-01
1.691865921020507812e-01
1.689617633819580078e-01
1.747071743011474609e-01
1.663930416107177734e-01
1.721012592315673828e-01
1.673042774200439453e-01
1.697895526885986328e-01
1.746222972869873047e-01
1.656408309936523438e-01
1.737916469573974609e-01
8.660626411437988281e-02
6.689143180847167969e-02
1.753594875335693359e-01
1.686890125274658203e-01
1.748406887054443359e-01
1.718916893005371094e-01
1.782059669494628906e-01
1.434986591339111328e-01
1.744742393493652344e-01
1.716113090515136719e-01
4.420447349548339844e-02
1.685547828674316406e-01
1.060924530029296875e-01
1.671724319458007812e-01
1.743760108947753906e-01
1.720342636108398438e-01
1.698484420776367188e-01
1.701993942260742188e-01
1.717898845672607422e-01
1.745438575744628906e-01
1.543800830841064453e-01
9.110426902770996094e-02
5.148983001708984375e-02
1.702871322631835938e-01
1.003310680389404297e-01
1.712381839752197266e-01
1.694993972778320312e-01
1.712827682495117188e-01
4.948616027832031250e-02
1.698105335235595703e-01
1.763222217559814453e-01
1.693069934844970703e-01
1.690146923065185547e-01
1.744904518127441406e-01
1.689844131469726562e-01
8.076810836791992188e-02
1.813745498657226562e-01
1.708130836486816406e-01
1.772749423980712891e-01
1.338427066802978516e-01
1.669785976409912109e-01
1.855409145355224609e-01
1.710155010223388672e-01
3.420519828796386719e-02
9.919142723083496094e-02
