2.215220928192138672e-01
1.789426803588867188e-01
1.817624568939208984e-01
1.810991764068603516e-01
1.857755184173583984e-01
1.813523769378662109e-01
1.808679103851318359e-01
1.811099052429199219e-01
1.811995506286621094e-01
1.904349327087402344e-01
1.833190917968750000e-01
1.805140972137451172e-01
1.826498508453369141e-01
1.815752983093261719e-01
1.906106472015380859e-01
1.818206310272216797e-01
1.787261962890625000e-01
1.779463291168212891e-01
1.806435585021972656e-01
1.802511215209960938e-01
1.845996379852294922e-01
1.807725429534912109e-01
1.877217292785644531e-01
1.809797286987304688e-01
1.782324314117431641e-01
1.792306900024414062e-01
1.787073612213134766e-01
1.790614128112792969e-01
1.773705482482910156e-01
1.776332855224609375e-01
1.796743869781494141e-01
1.812148094177246094e-01
1.845850944519042969e-01
1.795327663421630859e-01
1.795063018798828125e-01
1.786682605743408203e-01
1.792316436767578125e-01
1.790385246276855469e-01
1.791279315948486328e-01
1.809251308441162109e-01
1.795644760131835938e-01
1.802661418914794922e-01
1.780536174774169922e-01
1.777038574218750000e-01
1.813051700592041016e-01
1.782076358795166016e-01
1.785132884979248047e-01
1.847538948059082031e-01
1.853010654449462891e-01
1.816701889038085938e-01
1.799867153167724609e-01
1.795985698699951172e-01
1.884982585906982422e-01
1.795032024383544922e-01
1.777675151824951172e-01
1.789278984069824219e-01
1.784648895263671875e-01
1.801297664642333984e-01
1.795907020568847656e-01
1.776916980743408203e-01
1.828031539916992188e-01
1.794037818908691406e-01
1.791775226593017578e-01
1.881287097930908203e-01
1.800460815429687500e-01
1.782264709472656250e-01
1.764941215515136719e-01
1.799387931823730469e-01
1.801640987396240234e-01
1.790385246276855469e-01
1.794385910034179688e-01
1.778423786163330078e-01
1.809744834899902344e-01
1.787209510803222656e-01
1.974220275878906250e-01
1.868047714233398438e-01
1.837038993835449219e-01
1.793222427368164062e-01
1.782734394073486328e-01
1.785631179809570312e-01
1.773922443389892578e-01
1.806571483612060547e-01
1.809375286102294922e-01
1.990003585815429688e-01
1.783869266510009766e-01
1.768617630004882812e-01
1.781671047210693359e-01
1.838591098785400391e-01
1.794040203094482422e-01
1.782703399658203125e-01
1.778972148895263672e-01
1.799027919769287109e-01
1.800549030303955078e-01
1.772770881652832031e-01
1.797695159912109375e-01
1.782257556915283203e-01
2.077789306640625000e-01
1.923871040344238281e-01
1.785690784454345703e-01
1.794087886810302734e-01
