1.761965751647949219e-01
1.701080799102783203e-01
1.765809059143066406e-01
1.701886653900146484e-01
1.708014011383056641e-01
1.716296672821044922e-01
1.727132797241210938e-01
1.721665859222412109e-01
1.711113452911376953e-01
1.867177486419677734e-01
1.733789443969726562e-01
1.697263717651367188e-01
1.753940582275390625e-01
1.724760532379150391e-01
1.758482456207275391e-01
1.736361980438232422e-01
1.723055839538574219e-01
1.689591407775878906e-01
1.703526973724365234e-01
1.764111518859863281e-01
1.716063022613525391e-01
1.716432571411132812e-01
1.716494560241699219e-01
1.768133640289306641e-01
1.772484779357910156e-01
1.720995903015136719e-01
1.699185371398925781e-01
1.745822429656982422e-01
1.714334487915039062e-01
1.710112094879150391e-01
1.771786212921142578e-01
1.749296188354492188e-01
1.793432235717773438e-01
1.738505363464355469e-01
1.792042255401611328e-01
1.678924560546875000e-01
1.711590290069580078e-01
1.785709857940673828e-01
1.711943149566650391e-01
1.685554981231689453e-01
1.721463203430175781e-01
1.753916740417480469e-01
1.699116230010986328e-01
1.753332614898681641e-01
1.766736507415771484e-01
1.785559654235839844e-01
1.816732883453369141e-01
1.696569919586181641e-01
1.710886955261230469e-01
1.719574928283691406e-01
1.697180271148681641e-01
1.697390079498291016e-01
1.727738380432128906e-01
1.731894016265869141e-01
1.717376708984375000e-01
2.044746875762939453e-01
1.717567443847656250e-01
1.712937355041503906e-01
1.730675697326660156e-01
1.721169948577880859e-01
1.752657890319824219e-01
1.704761981964111328e-01
1.688218116760253906e-01
1.726226806640625000e-01
1.717302799224853516e-01
1.848955154418945312e-01
1.722447872161865234e-01
1.688475608825683594e-01
2.067956924438476562e-01
1.693391799926757812e-01
1.732959747314453125e-01
1.692192554473876953e-01
1.692230701446533203e-01
1.840591430664062500e-01
1.692004203796386719e-01
1.722030639648437500e-01
1.725440025329589844e-01
1.705698966979980469e-01
1.699223518371582031e-01
1.741247177124023438e-01
1.990275382995605469e-01
1.736500263214111328e-01
1.698284149169921875e-01
1.751594543457031250e-01
1.664242744445800781e-01
1.826493740081787109e-01
1.718480587005615234e-01
1.746659278869628906e-01
1.720061302185058594e-01
1.701872348785400391e-01
1.699924468994140625e-01
1.758935451507568359e-01
1.677699089050292969e-01
1.717047691345214844e-01
1.702916622161865234e-01
1.695730686187744141e-01
1.738171577453613281e-01
1.733758449554443359e-01
2.089347839355468750e-01
1.683928966522216797e-01
